#  学习时间 2018-09-27 20:26

vessel : 船舶，血管，容量
vertical : 垂直的
oblige   :强制的
obscure  :费解的
regardless : 不顾一切的
extent   : 程度，范围
exterior : 外部，外部的
external : 外在的，外部的
petrol   : 汽油
petroleum :石油
delay     :延误
decay    :腐烂，腐朽
decent   :像样的，体面的
route    :路线，路
ruin     : 破坏
sake     : 理由
satellite  :卫星
scale    : 规模 等级
temple   : 庙宇
tedious  ：冗余，乏味的
tend     ：趋向，招待
tendency : 趋向，趋势
ultimate : 最终，极品
undergo  : 经历，遭受
abundant : 丰富的
adopt    ：收养的
adapt    ：使适应，改编
bachelor : 学士，单身汉
casual   : 偶然的
trap     : 陷阱
vacant   ：空的，未占用的
vacuum   ：真空
oral     ：口头的
optics   : 光学
organ    ：器官，风琴
excess   : 超额的
expel    : 驱逐，开除，排除
expend   : 消费
expenditure :支出
expense  :开销，费用
expensive ：价格高的
expand : 扩大，膨胀的
expansion  : 扩大，膨胀
private : 私人的
individual : 个人的
personal  : 个人的
personnel : (全体）员工的
Pacific   ：太平洋
Atlantic  : 大西洋
Arctic    : 北极圈
Antarctic : 南极圈
grant     : 同意，授予
grand     ：壮丽的，重大的
invade    : 侵略，侵袭
acid      : 酸，尖刻的
acknowledge : 承认的
balcony   : 阳台的
calculate  : 计算
calendar   : 日历
optimistic  : 乐观的
optional    : 可选择的
outstanding ：杰出的
export     : 出口的
import    : 进口的
impose    ：迫使，强加于
religion  : 宗教
religious ：宗教的
victim   : 牺牲品，受害者
